G,Rfield,Rbaser,Rpos,oRAR,RAR
32,0,-0,1,-0,-0
2417,-15,-1,-7,320,305
136,1,2,-4,0,1
3,0,0,0,0,0
33,0,0,0,-0,-0
11,0,0,-1,-1,-1
3,0,0,0,0,0
2,0,0,0,0,0
49,3,-1,-2,-6,-3
138,1,1,3,36,37
91,1,0,-3,1,2
52,3,1,1,-7,-4
110,-7,-5,2,19,12
22,0,0,0,0,0
5,0,0,0,0,0
150,-11,5,3,54,43
96,15,1,4,-2,13
2,0,0,0,0,0
4,0,0,0,0,0
32,0,0,0,-0,-0
71,0,0,0,0,0
150,1,-1,-8,27,28
27,0,0,0,0,0
72,5,-2,1,10,15
76,0,0,0,0,0
7,-1,-0,-0,-1,-2
19,0,0,0,0,0
137,0,-0,8,41,41
