G,Rfield,Rbaser,Rpos,oRAR,RAR
32,0,-0,1,-0,-0
2417,-15,-1,-7,320,305
136,1,2,-4,0,1
3,0,0,0,0,0
33,0,0,0,-0,-0
11,0,0,-1,-1,-1
3,0,0,0,0,0
2,0,0,0,0,0
49,3,-1,-2,-6,-3
138,1,1,3,36,37
91,1,0,-3,1,2
52,3,1,1,-7,-4
59,-3,-1,3,16,13
19,0,0,0,0,0
11,0,0,0,0,0
45,2,0,-1,1,3
28,0,0,0,0,0
21,-4,0,1,-0,-4
32,0,-0,1,-1,-1
110,-7,-5,2,19,12
22,0,0,0,0,0
152,-13,-3,-7,55,42
58,6,1,3,12,18
96,15,1,4,-2,13
4,0,0,0,0,0
150,1,-1,-8,27,28
72,5,-2,1,10,15
19,0,0,0,0,0
30,0,0,-1,1,1
